######################################
#                                    #
#                                    #
#                                    #
#                                    #
#                EXIT                #
#                                    #
#                |  |                #
#                v  v                #
#                                    #
#                                    #
######################################
