╔════════════════════════════════════╗
║                                    ║
║                                    ║
║                                    ║
║                                    ║
║                                    ║
║                                    ║
║                                    ║
║                                    ║
║                                    ║
║                                    ║
╚════════════════════════════════════╝
