╔════════════════════════════════════╗
║░░░░░░░░░░░░░░░░░░░░░░░░░░░░░░░░░░░░║
║░░░     ░░░░░░░░░░░░░░░░░░░░░░░░░░░░║
║░░░ ××× ░░░░░░░░░░░░░░░░░░░░░░░░░░░░║
║░░░     ░░░░░░                      ║
║░░░░░░░░░░░░░░                      ║
║░░░░░░░░░░░░░░                      ║
║░░░░░░░░░░░░░░                      ║
║░░░░░░░░░░░░░░        ░░░░░░░░░░░░░░║
║░░░░░░░░░░░░░░        ░░░░░░░░░░░░░░║
║░░░░░░░░░░░░░░        ░░░░░░░░░░░░░░║
╚════════════════════════════════════╝
