╔═════════════╦═══════════╦══════════╗
║             ║           ║          ║
║             ║ ╔═══════╗ ║          ║
║             ║ ║       ║ ║          ║
║             ║ ║ ╔═══╗ ║ ║          ║
║             ║ ║ ║ ? ║ ║ ║          ║
║             ║ ║ ╚   ║ ║ ║          ║
║             ║ ╚═════╝ ║ ║          ║
║             ║         ║ ║          ║
║             ╚═════════╝ ╚          ║
║                                    ║
╚════════════════════════════════════╝
