╔════════════════════════════════════╗
║                                    ║
║                                    ║
║             ┌────┐                 ║
║             │    │     ┌─────┬┐    ║
║             │    └─────┤ ──┬─┴┘    ║
║             │          │  ─┤       ║
║             └──────────┤  ─┤       ║
║                        └───┘       ║
║                                    ║
║                                    ║
╚════════════════════════════════════╝
