╔═══╦═══════╦════════════╦═══════════╗
║   ║                    ║           ║
║ ╔═╣ ╔═════╣ ╔          ║ ╔═══════╗ ║
║ ║ ╚ ║     ║ ╠═╗ ╔╗ ╗ ╔ ║ ║       ║ ║
║ ╝   ║ ╔═╗ ║ ║   ║║ ║ ║ ╚ ║ ╔═══╗ ║ ║
║    ╔╝   ╝   ║ ╚═╣║ ╚╦╝   ╝ ║   ║ ║ ║
║╔ ╚═╣  ╔   ╔═╣   ╠╝  ║ ¤ ¤  ║ ╔ ║ ║ ║
║║   ║  ╚╝    ╠═╗ ╚ ¤ ║     ╔╝ ║ ╝ ║ ║
║╚╦╗ ╠╝    ╔══╝  ¤    ║╚╦═══║  ╝   ║ ║
║ ╚╝ ╚ ╚═══╝   ¤  ╚═══╝ ╝   ╚ ╔ ╚══╝ ║
║            ¤            ¤   ╝      ║
╚════════════════════════════════════╝
