╔════════════════════════════════════╗
║            ║           ╔╦═╗╔════╗  ║
║                        ╠╗╔╩╝╔╔═╦╝  ║
║  ╔═════════╝           ║╠╣╔═╣╚╦╝   ║
║  ║                     ╚╣╚╣╔╚╦╝    ║
║  ║                      ╚╣╚╝╔╝     ║
║══╝                       ╚╣ ╚╗     ║
║                           ╚══╩     ║
║                            ╔╗      ║
║       ╔ ╗    ╔ ╗        ╔══╩╩══╗   ║
║       ╚═╝    ╚═╝     ╔══╩══════╩══╗║
╚══════════════════════╩════════════╩╝
