╔═════════════════════════╦══════════╗
║                         ║          ║
║                ╔═╗      ║          ║
║                ╚ ╝      ║          ║
╠══ ════════╗                        ║
║           ║             ║          ║
║ ╔═══════╗ ║          ╔═════╦═══════║
║ ║╔      ║ ╠══════════║ ╔═╗ ║       ║
║ ║║    ╗ ║ ║            ╚ ╝ ║       ║
║ ╝╚════╩ ║ ║          ║     ╚═════ ═║
║         ║            ║             ║
╚═════════╩═╩══════════╩═════════════╝
