╔════════════════════════════════════╗
║                                    ║
║                                    ║
║         ┌───┐  ┐   ┌  ┌─┐ ┌        ║
║         │   │  │   │  │ │ │        ║
║         ├──┬┘  │   │  │ │ │        ║
║         │  └┐  │   │  │ │ │        ║
║         ┘   └  └───┘  ┘ └─┘        ║
║                                    ║
║                                    ║
║                                    ║
╚════════════════════════════════════╝
