╔════════════════════════════════════╗
║                                    ║
║                                    ║
║           CONGRATULATIONS!         ║
║                                    ║
║         YOU FOUND THE EXIT!        ║
║                                    ║
║           TOTAL POINTS:            ║
║                                    ║
║                                    ║
║                                    ║
╚════════════════════════════════════╝
