╔════════════════════════════════════╗
║┌──┐├──┐┌──┐├┐  ┌──┐├┐  ┌──┐    ┌──┐║
║│Ç │   ││^Λ│┌┘  │LO│ │  │░░│├───│  │║
║└──┘   └└──┘│   └──┘ │  └──┘    └──┘║
║ │┬      ┬└─┘   │    └──┘         ┬ ║
║ ││      │      └────┐            │ ║
║ │└──────┤           │            │ ║
║ ┴       │     ┌────────────┐     │ ║
║╔══╗    ┌──┐├──┘┌──┐├┘  ┌──┐┘   ┌──┐║
║║  ║    │└>│    │IT│    │DA│    │Y │║
║╚══╝    └──┘    └──┘───┤└──┘    └──┘║
╚════════════════════════════════════╝
