╔════════════════════════════════════╗
║                                    ║
║               ┌────┐               ║
║              ┌┤×  ×├┐              ║
║               └┐┌┐┌┘               ║
║                └┬┬┘                ║
║                 ││                 ║
║                 ││                 ║
║               ┌─┴┴─┐               ║
║              ┌┴────┴┐              ║
║             ┌┴──────┴┐             ║
╚════════════════════════════════════╝
