╔════════════════════════════════════╗
║     ×         ×         ×         ×║
║        ×        ×        ×        ×║
║   ×       ×       ×       ×       ×║
║×      ×      ×      ×      ×      ×║
║     ×     ×     ×     ×     ×     ×║
║×    ×    ×    ×    ×    ×    ×    ×║
║   ×   ×   ×   ×   ×   ×   ×   ×   ×║
║  ×  ×  ×  ×  ×  ×  ×  ×  ×  x  ×  ×║
║ × × × × × × × × × × × × × × × × × ×║
║××××××××××××××××××××××××××××××××××××║
╚════════════════════════════════════╝
