╔════════════════════════════════════╗
║                                    ║
║                                    ║
║     ┌──┐   ┌───┐  ┌───┐  ┐  ┌      ║
║     │  └┐  │   │  │   │  │ ┌┘      ║
║     │   │  ├───┤  ├──┬┘  ├─┤       ║
║     │  ┌┘  │   │  │  └┐  │ └┐      ║
║     └──┘   ┘   └  ┘   └  ┘  └─     ║
║                                    ║
║                                    ║
║                                    ║
╚════════════════════════════════════╝
