╔════════════════════════════════════╗
║                                    ║
║                                    ║
║     ┐      ┌───┐  ┌───┐  ┌─┬─┐     ║
║     │      │   │  │        │       ║
║     │      │   │  └───┐    │       ║
║     │      │   │      │    │       ║
║     └────  └───┘  └───┘    ┘       ║
║                                    ║
║                                    ║
║                                    ║
╚════════════════════════════════════╝
