╔════════════════════════════════════╗
║                                    ║
║                                    ║
║  ┌─┬─┐  ┌─┬─┐         ┌─┬─┐  ┌───┐ ║
║    │      │             │    │     ║
║    │      │             │    └───┐ ║
║    │      │             │        │ ║
║  └─┴─┘    ┘           └─┴─┘  └───┘ ║
║                                    ║
║                                    ║
║                                    ║
╚════════════════════════════════════╝
