╔════════════════════════════════════╗
║                                    ║
║                                    ║
║     ┐   ┌  ┌───┐  ┌───┐  ┌───┐     ║
║     │   │  │      │   │  │         ║
║     ├───┤  ├──┤   ├──┬┘  ├──┤      ║
║     │   │  │      │  └┐  │         ║
║     ┘   └  └───┘  ┘   └  └───┘     ║
║                                    ║
║                                    ║
║                                    ║
╚════════════════════════════════════╝
