╔════════════════════════════════════╗
║               Λ                    ║
║              Λ Λ  Λ                ║
║             Λ   ΛΛ Λ               ║
║            Λ    Λ   Λ    Λ         ║
║      Λ    Λ    Λ     Λ  Λ Λ        ║
║     Λ Λ  Λ    Λ       ΛΛ   Λ       ║
║    Λ   ΛΛ    Λ         Λ    Λ      ║
║   Λ     Λ   Λ           Λ    Λ     ║
║  ΛΛ     ΛΛ Λ Λ           Λ   ΛΛ    ║
║           ΛΛ ΛΛ         ΛΛΛ        ║
╚════════════════════════════════════╝
